111111
100001
10P001
100C01
100001
111111