111111
100001
10P001
100C01
1000E1
111111
