1111111111111111111111
1C10001011101110101111
1010101111111111111011
1000000P00000000001111
10111010100000C0111011
11111110C1101010001011
1000111011111000111011
1010101011111110C01011
11101110100010C0111011
100000C101010000000E11
1111111111111111111111
