1111111111111111111111
1C10001011101110101111
1010C01111111111111011
1000000P0000000000C111
1011101010000010111011
1111111011101010001011
1000C11011111010C11011
1010101011111110101011
1110111010001010111011
1000C00C101010000000E1
1111111111111111111111
