11111111111111
11010101110111
10101111111111
10000P0000C001
1010101C00C011
101010111E1011
11111111111111
