11111111111111111
1C000101110111011
10010111111111111
100000P0000000001
1011010100C00C011
1111110C110101C01
100111011111000M1
100101010011E1001
11111111111111111
